NO ./images/Baren.xpm
SO ./images/Black_hole.xpm
WE ./images/Ice.xpm
EA ./images/Lava.xpm

F 100,100,100
C 10,3,100

        1111111111111111111111111
        1000000000110000000000001
        1011000001110000001000001
        1001000000000000000000001
111111111011000001110000000000001
100000000011000001110111111111111
11110111111111011100000010001
11110111111111011101010010001 111
11000000110101011100000010001 101
10001000000000001100000010001 111
100E0000000000001101010010001
1100000111010101111101111000111
11110111 1110101 101111010001
11111111 1111111 111111111111